    GCP - Google Cloud Platform is a suite of cloud computing services offered by Google. It provides a range of services for computing, storage, databases, machine learning, and more. Some of the key services include: 
        Compute Engine (GCE) - Virtual Machines
        Google Kubernetes Engine (GKE) - Managed Kubernetes
        App Engine (GAE) - Platform as a Service (PaaS)
        Cloud Functions - Serverless Functions
        Cloud Run - Serverless Containers
        Cloud Storage - Object Storage
        Cloud SQL - Managed Relational Database
        Cloud Bigtable - NoSQL Database
        Cloud Spanner - Global Distributed Database
        Cloud Pub/Sub - Messaging Service
        Cloud Dataflow - Stream and Batch Data Processing
        Cloud Dataproc - Managed Spark and Hadoop
        Cloud AI Platform - Machine Learning Services
        Cloud AutoML - Custom Machine Learning Models
        Cloud Vision API - Image Recognition
        Cloud Natural Language API - Text Analysis
        Cloud Translation API - Language Translation
        Cloud Speech-to-Text API - Speech Recognition
        Cloud Text-to-Speech API - Text to Speech Conversion
        Cloud Identity and Access Management (IAM) - Access Control
        Cloud Monitoring - Performance Monitoring
        Cloud Logging - Log Management
        Cloud Deployment Manager - Infrastructure as Code
        Cloud Billing - Cost Management
        Cloud Security Command Center - Security Management
        Cloud Armor - DDoS Protection
        Cloud CDN - Content Delivery Network
        Cloud Interconnect - Dedicated Network Connection
        Cloud VPN - Virtual Private Network
        Cloud Load Balancing - Traffic Distribution
        Cloud DNS - Domain Name System